     *****************End
     *   *     *     *
     *** ***** * *****
     *     *     *   *
     * *** ***** *   *
     * * *       * * *
     * * * **    * * *
     * *   *  *  * * *
     * *** ********* *
     * *             *
Start*****************


     **********End
     *        *
     ****** ***
     *    *   *
     * ** * * *
     * *    * *
     * ** *** *
     * *  *   *
Start**********


     *************End
     *           *
     *** ***** ***
     *   *     * *
     ***** ***** *
     *         * *
     *** *** *** *
     *   * * *   *
     ***** * * ***
     * * *   *   *
     * * ***   * *
     *       * * *
Start*************
